NO ./textures/north.xpm
SO ./textures/south.xpm
WE ./textures/west.xpm
EA ./textures/east.xpm

F 51,51,51
C 135,206,235

1111111111
1000000001
1000000001
1000110001
1000110001
100000N001
1001000001
1001000001
1000000001
1111111111
